%%%%%%%
%P   %%
%%%% %%
%%%% .%
%%%%%%%